{
	"numTilesX": 12,
	"numTilesY": 12,
	"size": [64,64],
	"start": [32,32],
	"tileNames": ["","tile01","lava","ice","wall","bounce"],
	"tiles": [4,4,4,4,4,4,4,4,4,4,4,4,
			  4,0,0,0,0,0,0,0,0,0,0,4,
			  4,0,4,4,4,0,4,4,4,4,0,4,
			  4,0,0,0,0,0,0,0,0,0,0,4,
			  4,0,0,0,4,4,4,4,4,4,5,4,
			  4,0,0,0,0,0,0,0,0,0,0,4,
			  4,4,4,0,0,0,0,0,0,0,0,4,
			  4,0,0,0,0,3,3,3,0,0,0,4,
			  4,0,0,0,0,0,0,0,0,0,0,4,
			  4,0,0,0,0,0,0,0,0,0,5,4,
			  4,4,2,2,4,4,2,2,4,4,4,4
			  ]
}